NO ./map_tester/textures/wall1.xpm
SO ./map_tester/textures/wall1.xpm
WE ./map_tester/textures/wall1.xpm
EA ./map_tester/textures/wall1.xpm

F 12,75,2
C 50,50,123

111111
10N101
1111