NO ./map_tester/textures/wall1.xpm
SO ./map_tester/textures/wall1.xpm
WE ./map_tester/textures/wall1.xpm
EA ./map_tester/textures/wall1.xpm

F 75,75,75
C 50,50,50


111111111111111111111111111111111111111111111111111111111111111111111
100000000000000000000000000000000000000000000000000000000000000000001
100000000000000000000000111111111111100000000000000000000000000000001
100000000000000000000000000000000000000000000000000000000000000000001
100000000000000000000000000000000000000000000000000000000000000000001
100000000000000000000000111111111111100000000000000000000000000000001
100000000000000000000000000000000000000000000000000000000000000000001
111111111111111111111111111111111111111101111110111111111111011111111
100000000000000000000000000000000000000000000000000000000000000000001
100000000000000000000000000000000000000000000000000000000000000000001
111111111111101111111111111111111111111111111110111111111111111111111
100000000000000000000000100100000000000000000000000010000000000000001
100000000000000000000000100100000000000000000000000010000000000000001
100000000000000000000000100100000000000000000000000010000000000000001
100000000000000000000000100100000000000000000000000010000000000000001
111001100011111000110011000111110001100110001111100110011000111110001
111001100011111000110011000111110001100110001111100110011000111110001
111001100011111000110011000111110001100110001111100110011000111110001
111001100011111000110011000111110001100110001111100110011000111110001
111001100011111000110011000111110001100110001111100110011000111110001
111001100011111000110011000111110001100110001111100110011000111110001
111001100011111000110011000111110001100110001111100110011000111110001
111001100011111000110011000111110001100110001111100110011000111110001
111001100011111000110011000111110001100110001111100110011000111110001
111001100011111000110011000111110001100110001111100110011000111110001
111001100011111000110011000111110001100110001111100110011000111110001
111001100011111000110011000111110001100110001111100110011000111110001
111001100011111000110011000111110001100110001111100110011000111110001
111001100011111000110011000111110001100110001111100110011000111110001
111001100000001111110011000000011001100110000000110110011000000011001
111001100000001100110011000000011001100110000000110110011000000011001
111111100001111000111111000011110001111110000111100111111000011110001
101111100011000000011111000110000000111110001100000011111000110000001
100001100011000000000011000110000000000110001100000000011000110000001
100001100011111100000011000111111111110110001111110000011000111111001
100000000000000000000000000000000000000000000000000000000000000000001
100000000000000000000000000000000000000000000000000000000000000000001
100000000000000000000000000000000000000000000000000000000000000000001
100000000000000000000000000000000000000000000000000000000000000000001
100000000000000000000000000000000000000000000000000000000000000000001
100000000000000000000000000000000000000000000000000000000000000000011
111111111111111111111111111111111111111111111110111111111111111111101
100000000000000000000000000000000000000000000000000000000000000000001
101000000010000000100000100000000010000000000000000000000000000000001
101011111010111011111011101110111010011111010111011111011101110111001
100000001000101000001000001010100000000100010100000100000101010001001
111110101111101111101110101010111111010111110111110111010101011111001
100010100000001000001010101010000001010000000100000101010101000001001
101011111110101011111011101011111001111111010101111101110101111101001
101000000010101000100000100000100000000001010100010000010000010001001
101111111011101110101110111110101111111101110111010111011111010111001
100000100010100010100010000010100000010001010001010001000001010000001
101110111010111010111110101010111111011101011101011111010101011111101
100010001010100010001000101010001001000101010001000100010101000100001
111111101010101111101011101011101111110101010111110101110101110111001
100000101000001000101000101000100000010100000100010100010100010000001
101110101111101110101110111011111111010111110111010111011101111111001
101000100000100000100010101000000000010000010000010001010100000001001
101011111010111011111010101111111001111101011101111101010111111101001
101000001010101010000010000000101000000101010101000001000000010100001
101111101010101110111110111110101111110101010111011111011111010111101
101000101010000010000010100010000000010101000001000001010001000000001
101011101110111011111011101011111010000000000000000000000000000000001
100000000000000000000000000000000000000000000000000000000000000000001
100000000000000000000000000000000000000000000000000000000000000000001
111111111111111111100001111111111111111111000011111111111111111111101
100000000000000000000000000000000000000000000000000000000000000000001
100000000000000000000000000000000000000000000000000000000000000000001
1000000000000000000000000000000000N0000000000000000000000000000000001
100000000000000000000000000000000000000000000000000000000000000000001
111111111111111111111111111111111111111111111111111111111111111111111