NO ./map_tester/textures/wall1.xpm
SO ./map_tester/textures/wall1.xpm
WE ./map_tester/textures/wall1.xpm
EA ./map_tester/textures/wall1.xpm

F 12,75,4294967299
C 50,50,123

1111
10N1
1111